Class,Total_Samples,Correct,Accuracy,Precision,Recall,F1_Score,TP,FP,FN
Accelerating_and_revving_and_vroom,6,1,0.16666666666666666,0.3333333333333333,0.16666666666666666,0.2222222222222222,1,2,5
Accordion,9,8,0.8888888888888888,0.8,0.8888888888888888,0.8421052631578948,8,2,1
Acoustic_guitar,1,0,0.0,0.0,0.0,0.0,0,0,1
Bark,14,11,0.7857142857142857,0.9166666666666666,0.7857142857142857,0.8461538461538461,11,1,3
Bass_drum,14,11,0.7857142857142857,0.6111111111111112,0.7857142857142857,0.6875000000000001,11,7,3
Bass_guitar,13,10,0.7692307692307693,0.8333333333333334,0.7692307692307693,0.8,10,2,3
Bathtub_(filling_or_washing),11,2,0.18181818181818182,0.4,0.18181818181818182,0.25000000000000006,2,3,9
Bicycle_bell,13,12,0.9230769230769231,0.75,0.9230769230769231,0.8275862068965517,12,4,1
Burping_and_eructation,15,11,0.7333333333333333,0.6875,0.7333333333333333,0.7096774193548386,11,5,4
Bus,14,9,0.6428571428571429,0.45,0.6428571428571429,0.5294117647058824,9,11,5
Buzz,10,2,0.2,0.5,0.2,0.28571428571428575,2,2,8
Car_passing_by,12,8,0.6666666666666666,0.5714285714285714,0.6666666666666666,0.6153846153846153,8,6,4
Chewing_and_mastication,15,2,0.13333333333333333,0.25,0.13333333333333333,0.1739130434782609,2,6,13
Child_speech_and_kid_speaking,15,12,0.8,0.7058823529411765,0.8,0.7500000000000001,12,5,3
Chink_and_clink,8,2,0.25,0.4,0.25,0.3076923076923077,2,3,6
Chirp_and_tweet,13,6,0.46153846153846156,0.5,0.46153846153846156,0.48000000000000004,6,6,7
Church_bell,15,8,0.5333333333333333,0.6153846153846154,0.5333333333333333,0.5714285714285715,8,5,7
Clapping,10,7,0.7,0.875,0.7,0.7777777777777777,7,1,3
Computer_keyboard,15,8,0.5333333333333333,0.5,0.5333333333333333,0.5161290322580646,8,8,7
Crackle,15,9,0.6,0.45,0.6,0.5142857142857143,9,11,6
Cricket,14,3,0.21428571428571427,0.25,0.21428571428571427,0.23076923076923075,3,9,11
Crowd,1,0,0.0,0.0,0.0,0.0,0,0,1
Cupboard_open_or_close,13,7,0.5384615384615384,0.5833333333333334,0.5384615384615384,0.5599999999999999,7,5,6
Cutlery_and_silverware,7,0,0.0,0.0,0.0,0.0,0,2,7
Drawer_open_or_close,13,3,0.23076923076923078,0.3,0.23076923076923078,0.2608695652173913,3,7,10
Drip,1,0,0.0,0.0,0.0,0.0,0,0,1
Electric_guitar,10,9,0.9,0.6,0.9,0.7200000000000001,9,6,1
Fart,15,11,0.7333333333333333,0.5,0.7333333333333333,0.5945945945945945,11,11,4
Female_singing,13,9,0.6923076923076923,0.6428571428571429,0.6923076923076923,0.6666666666666666,9,5,4
Female_speech_and_woman_speaking,9,4,0.4444444444444444,0.6666666666666666,0.4444444444444444,0.5333333333333333,4,2,5
Fill_(with_liquid),8,3,0.375,0.75,0.375,0.5,3,1,5
Finger_snapping,15,15,1.0,0.8333333333333334,1.0,0.9090909090909091,15,3,0
Frying_(food),12,7,0.5833333333333334,0.5,0.5833333333333334,0.5384615384615384,7,7,5
Gasp,9,4,0.4444444444444444,1.0,0.4444444444444444,0.6153846153846153,4,0,5
Glockenspiel,11,10,0.9090909090909091,0.7692307692307693,0.9090909090909091,0.8333333333333333,10,3,1
Gong,15,10,0.6666666666666666,0.9090909090909091,0.6666666666666666,0.7692307692307692,10,1,5
Gurgling,10,6,0.6,0.5,0.6,0.5454545454545454,6,6,4
Harmonica,15,12,0.8,0.8571428571428571,0.8,0.8275862068965518,12,2,3
Hi-hat,14,13,0.9285714285714286,0.7647058823529411,0.9285714285714286,0.8387096774193549,13,4,1
Hiss,15,3,0.2,0.25,0.2,0.22222222222222224,3,9,12
Keys_jangling,15,10,0.6666666666666666,0.4,0.6666666666666666,0.5,10,15,5
Knock,14,12,0.8571428571428571,0.5714285714285714,0.8571428571428571,0.6857142857142857,12,9,2
Male_singing,13,11,0.8461538461538461,0.5789473684210527,0.8461538461538461,0.6875,11,8,2
Male_speech_and_man_speaking,12,6,0.5,0.6666666666666666,0.5,0.5714285714285715,6,3,6
Marimba_and_xylophone,15,5,0.3333333333333333,0.23809523809523808,0.3333333333333333,0.2777777777777778,5,16,10
Mechanical_fan,10,4,0.4,0.5,0.4,0.4444444444444445,4,4,6
Meow,12,3,0.25,0.375,0.25,0.3,3,5,9
Microwave_oven,14,7,0.5,0.5833333333333334,0.5,0.5384615384615384,7,5,7
Motorcycle,12,6,0.5,0.5454545454545454,0.5,0.5217391304347826,6,5,6
Printer,15,4,0.26666666666666666,0.36363636363636365,0.26666666666666666,0.30769230769230765,4,7,11
Purr,10,3,0.3,0.25,0.3,0.2727272727272727,3,9,7
Race_car_and_auto_racing,5,1,0.2,0.5,0.2,0.28571428571428575,1,1,4
Raindrop,4,1,0.25,0.5,0.25,0.3333333333333333,1,1,3
Run,13,5,0.38461538461538464,0.45454545454545453,0.38461538461538464,0.41666666666666663,5,6,8
Scissors,15,4,0.26666666666666666,0.23529411764705882,0.26666666666666666,0.25,4,13,11
Screaming,10,3,0.3,0.3,0.3,0.3,3,7,7
Shatter,15,6,0.4,0.35294117647058826,0.4,0.37500000000000006,6,11,9
Sigh,11,4,0.36363636363636365,0.5,0.36363636363636365,0.4210526315789474,4,4,7
Skateboard,15,12,0.8,0.6666666666666666,0.8,0.7272727272727272,12,6,3
Slam,8,5,0.625,0.5555555555555556,0.625,0.5882352941176471,5,4,3
Sneeze,12,8,0.6666666666666666,0.5,0.6666666666666666,0.5714285714285715,8,8,4
Squeak,4,0,0.0,0.0,0.0,0.0,0,0,4
Stream,14,8,0.5714285714285714,0.5714285714285714,0.5714285714285714,0.5714285714285714,8,6,6
Tap,13,8,0.6153846153846154,0.5714285714285714,0.6153846153846154,0.5925925925925927,8,6,5
Tick-tock,14,5,0.35714285714285715,0.29411764705882354,0.35714285714285715,0.3225806451612903,5,12,9
Toilet_flush,13,9,0.6923076923076923,0.6428571428571429,0.6923076923076923,0.6666666666666666,9,5,4
Traffic_noise_and_roadway_noise,11,7,0.6363636363636364,0.6363636363636364,0.6363636363636364,0.6363636363636364,7,4,4
Trickle_and_dribble,7,7,1.0,0.7777777777777778,1.0,0.8750000000000001,7,2,0
Walk_and_footsteps,8,0,0.0,0.0,0.0,0.0,0,2,8
Waves_and_surf,14,4,0.2857142857142857,0.23529411764705882,0.2857142857142857,0.2580645161290323,4,13,10
Whispering,13,7,0.5384615384615384,0.4375,0.5384615384615384,0.4827586206896552,7,9,6
Writing,15,7,0.4666666666666667,0.4375,0.4666666666666667,0.45161290322580644,7,9,8
Yell,5,2,0.4,0.5,0.4,0.4444444444444445,2,2,3
Zipper_(clothing),15,2,0.13333333333333333,0.16666666666666666,0.13333333333333333,0.14814814814814814,2,10,13
