Class,Total_Samples,Correct,Accuracy,Precision,Recall,F1_Score,TP,FP,FN
Accelerating_and_revving_and_vroom,6,1,0.16666666666666666,0.5,0.16666666666666666,0.25,1,1,5
Accordion,9,6,0.6666666666666666,0.75,0.6666666666666666,0.7058823529411765,6,2,3
Acoustic_guitar,1,0,0.0,0.0,0.0,0.0,0,0,1
Bark,14,9,0.6428571428571429,0.75,0.6428571428571429,0.6923076923076924,9,3,5
Bass_drum,14,10,0.7142857142857143,0.7142857142857143,0.7142857142857143,0.7142857142857143,10,4,4
Bass_guitar,13,11,0.8461538461538461,0.6875,0.8461538461538461,0.7586206896551724,11,5,2
Bathtub_(filling_or_washing),11,2,0.18181818181818182,0.5,0.18181818181818182,0.26666666666666666,2,2,9
Bicycle_bell,13,12,0.9230769230769231,0.6666666666666666,0.9230769230769231,0.7741935483870968,12,6,1
Burping_and_eructation,15,6,0.4,0.3333333333333333,0.4,0.3636363636363636,6,12,9
Bus,14,10,0.7142857142857143,0.5882352941176471,0.7142857142857143,0.6451612903225806,10,7,4
Buzz,10,3,0.3,0.3333333333333333,0.3,0.3157894736842105,3,6,7
Car_passing_by,12,7,0.5833333333333334,0.3888888888888889,0.5833333333333334,0.4666666666666666,7,11,5
Chewing_and_mastication,15,2,0.13333333333333333,0.14285714285714285,0.13333333333333333,0.1379310344827586,2,12,13
Child_speech_and_kid_speaking,15,12,0.8,0.6,0.8,0.6857142857142857,12,8,3
Chink_and_clink,8,1,0.125,1.0,0.125,0.2222222222222222,1,0,7
Chirp_and_tweet,13,6,0.46153846153846156,0.5,0.46153846153846156,0.48000000000000004,6,6,7
Church_bell,15,11,0.7333333333333333,0.6875,0.7333333333333333,0.7096774193548386,11,5,4
Clapping,10,4,0.4,0.4444444444444444,0.4,0.4210526315789474,4,5,6
Computer_keyboard,15,5,0.3333333333333333,0.35714285714285715,0.3333333333333333,0.3448275862068965,5,9,10
Crackle,15,6,0.4,0.4,0.4,0.4000000000000001,6,9,9
Cricket,14,5,0.35714285714285715,0.35714285714285715,0.35714285714285715,0.35714285714285715,5,9,9
Crowd,1,0,0.0,0.0,0.0,0.0,0,1,1
Cupboard_open_or_close,13,9,0.6923076923076923,0.6923076923076923,0.6923076923076923,0.6923076923076923,9,4,4
Cutlery_and_silverware,7,0,0.0,0.0,0.0,0.0,0,1,7
Drawer_open_or_close,13,5,0.38461538461538464,0.23809523809523808,0.38461538461538464,0.2941176470588235,5,16,8
Drip,1,0,0.0,0.0,0.0,0.0,0,0,1
Electric_guitar,10,9,0.9,0.6,0.9,0.7200000000000001,9,6,1
Fart,15,6,0.4,0.5454545454545454,0.4,0.4615384615384615,6,5,9
Female_singing,13,7,0.5384615384615384,0.5833333333333334,0.5384615384615384,0.5599999999999999,7,5,6
Female_speech_and_woman_speaking,9,3,0.3333333333333333,0.5,0.3333333333333333,0.4,3,3,6
Fill_(with_liquid),8,2,0.25,0.3333333333333333,0.25,0.28571428571428575,2,4,6
Finger_snapping,15,15,1.0,0.625,1.0,0.7692307692307693,15,9,0
Frying_(food),12,8,0.6666666666666666,0.42105263157894735,0.6666666666666666,0.5161290322580646,8,11,4
Gasp,9,3,0.3333333333333333,0.6,0.3333333333333333,0.42857142857142855,3,2,6
Glockenspiel,11,11,1.0,1.0,1.0,1.0,11,0,0
Gong,15,10,0.6666666666666666,0.7142857142857143,0.6666666666666666,0.689655172413793,10,4,5
Gurgling,10,3,0.3,0.6,0.3,0.4,3,2,7
Harmonica,15,11,0.7333333333333333,0.7857142857142857,0.7333333333333333,0.7586206896551724,11,3,4
Hi-hat,14,13,0.9285714285714286,0.7222222222222222,0.9285714285714286,0.8125000000000001,13,5,1
Hiss,15,4,0.26666666666666666,0.4,0.26666666666666666,0.32,4,6,11
Keys_jangling,15,11,0.7333333333333333,0.5238095238095238,0.7333333333333333,0.611111111111111,11,10,4
Knock,14,11,0.7857142857142857,0.4782608695652174,0.7857142857142857,0.5945945945945946,11,12,3
Male_singing,13,10,0.7692307692307693,0.45454545454545453,0.7692307692307693,0.5714285714285714,10,12,3
Male_speech_and_man_speaking,12,4,0.3333333333333333,0.5714285714285714,0.3333333333333333,0.4210526315789474,4,3,8
Marimba_and_xylophone,15,8,0.5333333333333333,0.5333333333333333,0.5333333333333333,0.5333333333333333,8,7,7
Mechanical_fan,10,7,0.7,0.7,0.7,0.7,7,3,3
Meow,12,4,0.3333333333333333,0.4,0.3333333333333333,0.3636363636363636,4,6,8
Microwave_oven,14,4,0.2857142857142857,0.5,0.2857142857142857,0.36363636363636365,4,4,10
Motorcycle,12,5,0.4166666666666667,0.23809523809523808,0.4166666666666667,0.30303030303030304,5,16,7
Printer,15,3,0.2,0.3,0.2,0.24,3,7,12
Purr,10,1,0.1,0.125,0.1,0.11111111111111112,1,7,9
Race_car_and_auto_racing,5,1,0.2,1.0,0.2,0.33333333333333337,1,0,4
Raindrop,4,1,0.25,1.0,0.25,0.4,1,0,3
Run,13,4,0.3076923076923077,0.21052631578947367,0.3076923076923077,0.25,4,15,9
Scissors,15,4,0.26666666666666666,0.36363636363636365,0.26666666666666666,0.30769230769230765,4,7,11
Screaming,10,5,0.5,0.7142857142857143,0.5,0.588235294117647,5,2,5
Shatter,15,4,0.26666666666666666,0.19047619047619047,0.26666666666666666,0.2222222222222222,4,17,11
Sigh,11,0,0.0,0.0,0.0,0.0,0,1,11
Skateboard,15,9,0.6,0.6923076923076923,0.6,0.6428571428571429,9,4,6
Slam,8,2,0.25,0.25,0.25,0.25,2,6,6
Sneeze,12,8,0.6666666666666666,0.2857142857142857,0.6666666666666666,0.4,8,20,4
Squeak,4,0,0.0,0.0,0.0,0.0,0,0,4
Stream,14,7,0.5,0.6363636363636364,0.5,0.56,7,4,7
Tap,13,7,0.5384615384615384,0.7,0.5384615384615384,0.608695652173913,7,3,6
Tick-tock,14,6,0.42857142857142855,0.46153846153846156,0.42857142857142855,0.4444444444444445,6,7,8
Toilet_flush,13,3,0.23076923076923078,0.3333333333333333,0.23076923076923078,0.27272727272727276,3,6,10
Traffic_noise_and_roadway_noise,11,4,0.36363636363636365,0.3076923076923077,0.36363636363636365,0.33333333333333337,4,9,7
Trickle_and_dribble,7,5,0.7142857142857143,0.5555555555555556,0.7142857142857143,0.6250000000000001,5,4,2
Walk_and_footsteps,8,0,0.0,0.0,0.0,0.0,0,0,8
Waves_and_surf,14,6,0.42857142857142855,0.35294117647058826,0.42857142857142855,0.3870967741935484,6,11,8
Whispering,13,8,0.6153846153846154,0.6153846153846154,0.6153846153846154,0.6153846153846154,8,5,5
Writing,15,6,0.4,0.6,0.4,0.48,6,4,9
Yell,5,1,0.2,0.3333333333333333,0.2,0.25,1,2,4
Zipper_(clothing),15,2,0.13333333333333333,0.08333333333333333,0.13333333333333333,0.10256410256410255,2,22,13
